ALLES=allès
alles=allès
UZES=uzès
uzes=uzès
arles=arle
SEGURA=ségura
monsieur=meussieu
T-shirts=tishirt
Csoukha=céssouka
ukulélé=oukoulélé
1er=premier
11e=onzième
3e=troixième
5e=cinquième
6e=sixième
13e=treizième
Teresa=thérésa
7e=septième
Stevenson=stivenson
Pons=ponss
CIVAM=C.I.V.A.M.
AB=A.B.
SCA=S.C.A.
CUCS=C.U.C.S
PIM’S=P.I.M.'S
CAUE=C.A.U.E.
CM1=C.M1
CM2=C.M2
président=présidant
ZA=Z.A.
Sand=Sande
Cheylon=chailon
CRDEE=C.R.D.E.E.
d’Occ=d'oc
Portalès=portaless
poëles=poiles
souligne- t-il=souligne-til
Haüy=hahuui
mas=mass
biou=bioôou
Collias=Coliass
Clap=clape
PRAT=PRATT
PORTALÈS=PORTALESS
Uzès=Uzèss
MARTINEZ=MARTINEZZ
Comps=Comppss
Lot=Lott
Claeys=Claeyss
Chase=Tchaise
Westlake=west lake
Dreams=drims
Magnum=magnom
Junas=Junass
Miller=Milerr
Ners=Nerss
Chao=Tchao
Palestine=Palesstine
Dubuc=Dubicc
Cornélius=Cornéliuss
Villeger=Villgerr
Lockwood=Lockwoudd
Encol=Encoll
Alix=Alix
band=bandd
Markus=Marcuss